###################
#################				  #
##################  #
##################				  #
#			   	  #
#				  #
#			###	  #
#				  #
###########				  #
#				  #
#				  #
#		#########		  #
#				  #
#				  #
#				  #
#				  #
#			##	  #
#				  #
#				  #
###################